60 60 60 60 60 60 60 60 60 60 60 60 60 60 60 60 60 60 60 60 60 60 60 60 60 60 60 60 60 60 60 60 60 60 60 60 60 60 60 60 60 60 60 60 60 60 60 60 60 60 60 60 60 60 60 60 60 60 60 60 60 60 60
60 0  0  0  0  0  0  0  0  0  0  0  0  0  0  0  0  0  0  0  0  0  0  0  0  0  28 0  0  0  0  0  0  0  28 0  0  0  0  28 0  0  0  0  0  0  0  28 0  0  0  0  0  0  0  0  0  0  0  0  0  0  60
60 0  0  0  0  0  0  0  0  0  0  0  0  0  0  0  0  0  0  0  0  0  0  0  0  0  28 0  0  0  0  0  0  0  28 0  0  0  0  28 0  0  0  0  0  0  0  28 0  0  0  0  0  0  0  0  0  0  0  0  0  0  60
60 0  0  0  0  0  0  0  0  0  0  0  0  0  0  0  0  0  0  0  0  0  0  0  0  0  28 0  0  0  0  0  0  0  28 0  0  0  0  28 0  0  0  0  0  0  0  28 0  0  0  0  0  0  0  0  0  0  0  0  0  0  60
60 0  0  0  0  0  0  0  0  0  0  0  0  0  0  0  0  0  0  0  0  0  0  0  0  0  28 0  0  0  0  0  0  0  28 0  0  0  0  28 0  0  0  0  0  0  0  28 0  0  0  0  0  0  0  0  0  0  0  0  0  0  60
60 0  0  0  0  0  0  0  0  0  0  0  0  0  0  0  0  0  0  0  0  0  0  0  0  0  0  0  0  0  0  0  0  0  0  0  0  0  0  0  0  0  0  0  0  0  0  0  0  0  0  0  0  0  0  0  0  0  0  0  0  0  60
60 0  0  0  0  0  0  0  0  0  0  0  0  0  0  0  0  0  0  0  0  0  0  0  0  0  0  0  0  0  0  0  0  0  0  0  0  0  0  0  0  0  0  0  0  0  0  0  0  0  0  0  0  0  0  0  0  0  0  0  0  0  60
60 0  0  0  0  0  0  0  0  0  0  0  0  0  0  0  0  0  0  0  0  0  0  0  0  0  28 0  0  0  0  0  0  0  28 0  0  0  0  28 0  0  0  0  0  0  0  28 0  0  0  0  0  0  0  0  0  0  0  0  0  0  60
60 0  0  0  0  0  0  0  0  0  0  0  0  0  0  0  0  0  0  0  0  0  0  0  0  0  28 0  0  0  0  0  0  0  28 0  0  0  0  28 0  0  0  0  0  0  0  28 0  0  0  0  0  0  0  0  0  0  0  0  0  0  60
60 0  0  0  0  0  0  0  0  0  0  0  0  0  0  0  0  0  0  0  0  0  0  0  0  0  28 0  0  0  0  0  0  0  28 0  0  0  0  28 0  0  0  0  0  0  0  28 0  0  0  0  0  0  0  0  0  0  0  0  0  0  60
60 0  0  0  0  0  0  0  0  0  0  0  0  0  0  0  0  0  0  0  0  0  0  0  0  0  28 0  0  0  0  0  0  0  28 0  0  0  0  28 0  0  0  0  0  0  0  28 0  0  0  0  0  0  0  0  0  0  0  0  0  0  60
60 0  0  0  0  0  0  0  0  0  0  0  0  0  0  0  0  0  0  0  0  0  0  0  0  0  60 60 60 60 60 60 60 60 60 0  0  0  0  60 60 60 60 60 60 60 60 60 0  0  0  0  0  0  0  0  0  0  0  0  0  0  60
60 0  0  0  0  0  0  0  0  0  0  0  0  0  0  0  0  0  0  0  0  0  0  0  0  0  60 58 0  58 0  58 0  58 0  0  0  0  0  0  58 0  58 0  58 0  58 60 0  0  0  0  0  0  0  0  0  0  0  0  0  0  60
60 0  0  0  0  0  0  0  0  0  0  0  0  0  0  0  0  0  0  0  0  0  0  0  0  0  60 0  0  0  0  0  0  0  0  0  0  0  0  0  0  0  0  0  0  0  0  60 0  0  0  0  0  0  0  0  0  0  0  0  0  0  60
60 0  0  0  0  0  0  0  0  0  0  0  0  0  0  0  0  0  0  0  0  0  0  0  0  0  60 58 0  0  0  0  0  0  0  0  0  0  0  0  0  0  0  0  0  0  58 60 0  0  0  0  0  0  0  0  0  0  0  0  0  0  60
60 0  0  0  0  0  0  0  0  0  0  0  0  0  0  0  0  0  0  0  0  0  0  0  0  0  60 0  0  0  27 0  0  0  0  0  0  0  0  0  0  0  0  27 0  0  0  60 0  0  0  0  0  0  0  0  0  0  0  0  0  0  60
60 0  0  0  0  0  0  0  0  0  0  0  0  0  0  0  0  0  0  0  0  0  0  0  0  0  60 58 0  0  0  0  0  0  0  0  0  0  0  0  0  0  0  0  0  0  58 60 0  0  0  0  0  0  0  0  0  0  0  0  0  0  60
60 0  0  0  0  0  0  0  0  0  0  0  0  0  0  0  0  0  0  0  0  0  0  0  0  0  60 0  0  0  0  0  0  0  0  0  0  0  0  0  0  0  0  0  0  0  0  60 0  0  0  0  0  0  0  0  0  0  0  0  0  0  60
60 0  0  0  0  0  0  0  0  0  0  0  0  0  0  0  0  0  0  0  0  0  0  0  0  0  60 58 0  0  0  0  0  0  0  0  0  0  0  0  0  0  0  0  0  0  58 60 0  0  0  0  0  0  0  0  0  0  0  0  0  0  60
60 0  0  0  0  0  0  0  0  0  0  0  0  0  0  0  0  0  0  0  0  0  0  0  0  0  60 0  0  0  0  0  0  0  0  0  0  0  0  0  0  0  0  0  0  0  0  60 0  0  0  0  0  0  0  0  0  0  0  0  0  0  60
60 0  0  0  0  0  0  0  0  0  0  0  0  0  0  0  0  0  0  0  0  0  0  0  0  0  0  0  0  0  0  0  0  0  0  0  0  0  0  0  0  0  0  0  0  0  0  0  0  0  0  0  0  0  0  0  0  0  0  0  0  0  60
60 0  0  0  0  0  0  0  0  0  0  0  0  0  0  0  0  0  0  0  0  0  0  0  0  0  0  0  0  0  0  0  0  0  0  0  38 38 0  0  0  0  0  0  0  0  0  0  0  0  0  0  0  0  0  0  0  0  0  0  0  0  60
60 0  0  0  0  0  0  0  0  0  0  0  0  0  0  0  0  0  0  0  0  0  0  0  0  0  0  0  0  0  0  0  0  0  0  0  38 38 0  0  0  0  0  0  0  0  0  0  0  0  0  0  0  0  0  0  0  0  0  0  0  0  60
60 0  0  0  0  0  0  0  0  0  0  0  0  0  0  0  0  0  0  0  0  0  0  0  0  0  0  0  0  0  0  0  0  0  0  0  0  0  0  0  0  0  0  0  0  0  0  0  0  0  0  0  0  0  0  0  0  0  0  0  0  0  60
60 0  0  0  0  0  0  0  0  0  0  0  0  0  0  0  0  0  0  0  0  0  0  0  0  0  60 0  0  0  0  0  0  0  0  0  0  0  0  0  0  0  0  0  0  0  0  60 0  0  0  0  0  0  0  0  0  0  0  0  0  0  60
60 0  0  0  0  0  0  0  0  0  0  0  0  0  0  0  0  0  0  0  0  0  0  0  0  0  60 58 0  0  0  0  0  0  0  0  0  0  0  0  0  0  0  0  0  0  58 60 0  0  0  0  0  0  0  0  0  0  0  0  0  0  60
60 0  0  0  0  0  0  0  0  0  0  0  0  0  0  0  0  0  0  0  0  0  0  0  0  0  60 0  0  0  0  0  0  0  0  0  0  0  0  0  0  0  0  0  0  0  0  60 0  0  0  0  0  0  0  0  0  0  0  0  0  0  60
60 0  0  0  0  0  0  0  0  0  0  0  0  0  0  0  0  0  0  0  0  0  0  0  0  0  60 58 0  0  0  0  0  0  0  0  0  0  0  0  0  0  0  0  0  0  58 60 0  0  0  0  0  0  0  0  0  0  0  0  0  0  60
60 0  0  0  0  0  0  0  0  0  0  0  0  0  0  0  0  0  0  0  0  0  0  0  0  0  60 0  0  0  27 0  0  0  0  0  0  0  0  0  0  0  0  27  0  0  0 60 0  0  0  0  0  0  0  0  0  0  0  0  0  0  60
60 0  0  0  0  0  0  0  0  0  0  0  0  0  0  0  0  0  0  0  0  0  0  0  0  0  60 58 0  0  0  0  0  0  0  0  0  0  0  0  0  0  0  0  0  0  58 60 0  0  0  0  0  0  0  0  0  0  0  0  0  0  60
60 0  0  0  0  0  0  0  0  0  0  0  0  0  0  0  0  0  0  0  0  0  0  0  0  0  60 0  0  0  0  0  0  0  0  0  0  0  0  0  0  0  0  0  0  0  0  60 0  0  0  0  0  0  0  0  0  0  0  0  0  0  60
60 0  0  0  0  0  0  0  0  0  0  0  0  0  0  0  0  0  0  0  0  0  0  0  0  0  60 58 0  58 0  58 0  58 0  0  0  0  0  0  58 0  58 0  58 0  58 60 0  0  0  0  0  0  0  0  0  0  0  0  0  0  60
60 32 32 32 32 0  0  0  0  32 32 32 32 32 32 32 32 0  0  32 32 32 32 32 32 32 60 60 60 60 60 60 60 60 60 0  0  0  0  60 60 60 60 60 60 60 60 60 0  0  0  0  0  0  0  0  0  0  0  0  0  0  60
60 32 32 3  3  0  0  0  0  3  3  32 32 0  0  0  0  0  0  0  0  0  0  0  0  0  28 0  0  0  0  0  0  0  28 0  0  0  0  28 0  0  0  0  0  0  0  28 0  0  0  0  0  0  0  0  0  0  0  0  0  0  60
60 0  0  3  3  0  0  0  0  3  3  0  0  0  0  0  0  0  0  0  0  0  0  0  0  0  28 0  0  0  0  0  0  0  28 0  0  0  0  28 0  0  0  0  0  0  0  28 0  0  0  0  0  0  0  0  0  0  0  0  0  0  60
60 0  0  3  3  0  0  0  0  3  3  0  0  0  0  0  0  0  0  0  0  0  0  0  0  0  28 0  0  0  0  0  0  0  28 0  0  0  0  28 0  0  0  0  0  0  0  28 0  0  0  0  0  0  0  0  0  0  0  0  0  0  60
60 0  0  3  3  0  0  0  0  3  3  0  0  0  0  0  0  0  0  0  0  0  0  0  0  0  28 0  0  0  0  0  0  0  28 0  0  0  0  28 0  0  0  0  0  0  0  28 0  0  0  0  0  0  0  0  0  0  0  0  0  0  60
60 0  0  3  4  0  0  0  0  4  3  0  0  0  0  0  0  0  0  0  0  0  0  0  0  0  0  0  0  0  0  0  0  0  0  0  0  0  0  0  0  0  0  0  0  0  0  0  0  0  0  0  0  0  0  0  0  0  0  0  0  0  60
60 0  0  3  3  4  5  5  4  3  3  0  0  0  0  0  0  0  0  0  0  0  0  0  0  0  26 0  0  0  0  0  0  0  26 0  0  0  0  26 0  0  0  0  0  0  0  26 0  0  0  0  0  0  0  0  0  0  0  0  0  0  60
60 0  0  3  3  3  3  3  3  3  3  0  0  0  0  0  0  0  0  0  0  0  0  0  0  0  0  0  0  0  0  0  0  0  0  0  0  0  0  0  0  0  0  0  0  0  0  0  0  0  0  0  0  0  0  0  0  60 60 60 60 60 60
60 0  0  3  3  3  3  3  3  3  3  0  0  0  0  0  0  0  0  0  0  0  0  0  0  0  28 0  0  0  0  0  0  0  28 0  0  0  0  28 0  0  0  0  0  0  0  28 0  0  0  0  0  0  0  0  0  60 0  0  0  0  60
60 0  0  0  0  0  0  0  0  0  0  0  0  0  0  0  0  0  0  0  0  0  0  0  0  0  28 0  0  0  0  0  0  0  28 0  0  0  0  28 0  0  0  0  0  0  0  28 0  0  0  0  0  0  0  0  0  60 0  0  0  0  60
60 0  0  0  0  0  0  0  0  0  0  0  0  0  0  0  0  0  0  0  0  0  0  0  0  0  28 0  0  0  0  0  0  0  28 0  0  0  0  28 0  0  0  0  0  0  0  28 0  0  0  0  0  0  0  0  0  0  0  60 60 0  60
60 0  0  0  0  0  0  0  0  0  0  0  0  0  0  0  0  0  0  0  0  0  0  0  0  0  28 0  0  0  0  0  0  0  28 0  0  0  0  28 0  0  0  0  0  0  0  28 0  0  0  0  0  0  0  0  0  0  0  60 1  0  1
60 60 60 60 60 60 60 60 60 60 60 60 60 60 60 60 60 60 60 60 60 60 60 60 60 60 60 60 60 60 60 60 60 60 60 60 60 60 60 60 60 60 60 60 60 60 60 60 60 60 60 60 60 60 60 60 60 60 60 60 1  1  1