20 20 20 20 20 20 20 20 20 20 20 20 20 20 20 20 20 20 20 20 20
20 0  0  0  0  0  0  0  0  0  0  0  21 0  0  0  0  0  0  0  20
20 0  0  0  0  0  0  0  0  0  0  0  21 0  21 0  0  0  0  0  20
20 0  0  0  0  0  0  0  0  0  0  0  0  0  21 0  0  0  0  0  20
20 20 20 20 0  20 20 20 0  20 20 20 21 0  21 0  0  0  0  0  20
20 20 20 20 0  20 20 0  0  20 0  0  21 0  21 0  0  0  0  0  20
20 20 0  0  0  20 20 0  20 20 0  0  21 0  21 0  0  0  0  0  20
20 20 0  20 20 20 20 0  0  0  0  0  21 0  21 0  0  0  0  0  20
20 20 0  0  0  0  20 0  0  0  0  0  21 0  21 0  0  0  0  0  20
20 20 20 20 20 0  20 0  0  0  0  0  21 0  21 0  0  0  0  0  20
20 0  0  0  20 0  20 0  0  0  0  0  21 0  21 0  0  0  0  0  20
20 0  0  0  20 0  20 0  0  0  0  0  21 0  21 0  0  0  0  0  20
20 0  0  0  20 0  20 0  0  0  0  0  21 0  21 0  0  0  0  0  20
20 0  0  0  20 0  20 0  0  0  0  0  21 0  21 0  0  0  0  0  20
20 0  0  0  20 0  20 0  0  0  0  0  21 0  21 0  0  0  0  0  20
20 0  0  0  20 0  20 0  0  0  0  0  21 0  21 0  0  0  0  0  20
20 0  20 20 20 0  20 0  0  0  0  0  21 0  21 0  0  0  0  0  20
20 0  0  0  0  0  20 0  0  0  0  0  21 0  21 0  0  0  0  0  20
20 20 0  20 20 20 20 20 20 0  20 20 21 0  21 0  0  0  0  0  20
20 20 0  20 0  0  0  0  0  0  0  0  21 0  21 0  0  0  0  0  20
20 20 0  20 0  0  0  0  0  0  0  0  21 0  21 0  0  0  0  0  20
20 20 0  20 0  0  0  0  0  0  0  0  21 0  21 0  0  0  0  0  20
20 0  0  0  0  0  0  0  0  0  0  0  21 0  21 21 21 21 0  0  20
20 0  0  0  0  0  0  0  0  0  0  0  21 0  0  0  0  21 0  0  20
20 0  0  0  0  0  0  0  0  0  0  0  21 21 21 21 0  21 0  0  20
20 20 20 20 0  20 20 20 0  20 20 20 21 21 1  21 0  21 0  0  20
20 20 20 20 0  20 20 20 0  20 20 20 21 21 0  21 0  21 0  0  20
20 20 20 20 0  20 20 20 0  20 20 20 21 21 0  21 0  21 0  0  20
20 20 20 20 0  20 20 20 0  20 20 20 21 21 0  0  0  21 0  0  20
20 20 20 20 0  20 20 20 0  20 20 20 21 21 21 21 21 21 0  0  20
20 20 20 20 0  20 20 20 0  20 20 20 21 0  0  0  0  0  0  0  20
20 20 20 20 0  20 20 20 0  20 20 20 21 0  0  0  0  0  0  0  20
20 20 20 20 0  20 20 20 0  20 20 20 21 0  0  0  0  0  0  0  20
20 20 20 20 0  20 20 20 0  20 20 20 21 0  0  0  0  0  0  0  20
20 20 20 20 0  20 20 20 0  20 20 20 21 0  0  0  0  0  0  0  20
20 20 20 20 0  20 20 20 0  20 20 20 21 0  0  0  0  0  0  0  20
20 20 20 20 0  20 20 20 0  20 20 20 21 0  0  0  21 0  0  0  20
20 20 20 20 0  20 20 20 0  20 20 20 21 0  0  0  0  0  0  0  20
20 20 20 20 0  20 20 20 0  20 20 20 21 0  0  0  0  0  0  0  20
20 20 20 20 0  20 20 20 0  20 20 20 21 0  0  0  0  0  0  0  20
20 20 20 20 0  20 20 20 0  20 20 20 21 0  0  0  0  0  0  0  20
20 20 20 20 0  20 20 20 0  20 20 20 21 0  0  0  0  0  0  0  20
20 20 20 20 0  20 20 20 0  20 20 20 21 0  0  0  21 0  0  0  20
20 20 20 20 0  20 20 20 0  20 20 20 21 0  0  0  0  0  0  0  20
20 20 20 20 0  20 20 20 0  20 20 20 21 0  0  0  0  0  0  0  20
20 20 20 20 0  20 20 20 0  20 20 20 21 0  0  0  0  0  0  0  20
20 20 20 20 0  20 20 20 0  20 20 20 21 0  0  0  0  0  0  0  20
20 20 20 20 0  20 20 20 0  20 20 20 21 0  0  0  0  0  0  0  20
20 20 20 20 0  20 20 20 0  20 20 20 21 0  0  0  21 0  0  0  20
20 20 20 20 0  20 20 20 0  20 20 20 21 0  0  0  0  0  0  0  20
20 20 20 20 0  20 20 20 0  20 20 20 21 0  0  0  0  0  0  0  20
20 20 20 20 0  20 20 20 0  20 20 20 21 0  0  0  0  0  0  0  20
20 20 20 20 0  20 20 20 0  20 20 20 21 0  0  0  0  0  0  0  20
20 20 20 20 0  20 20 20 0  20 20 20 21 0  0  0  0  0  0  0  20
20 20 20 20 0  20 20 20 0  20 20 20 21 0  0  0  21 0  0  0  20
20 20 20 20 0  20 20 20 0  20 20 20 21 0  0  0  0  0  0  0  20
20 20 20 20 0  20 20 20 0  20 20 20 21 0  0  0  0  0  0  0  20
20 20 20 20 0  20 20 20 0  20 20 20 21 0  0  0  0  0  0  0  20
20 20 20 20 0  20 20 20 0  20 20 20 21 0  0  0  0  0  0  0  20
20 20 20 20 0  20 20 20 0  20 20 20 21 0  0  0  0  0  0  0  20
20 20 20 20 0  20 20 20 0  20 20 20 21 0  0  0  21 0  0  0  20
20 20 20 20 0  20 20 20 0  20 20 20 21 0  0  0  0  0  0  0  20
20 20 20 20 0  20 20 20 0  20 20 20 21 0  0  0  0  0  0  0  20
20 20 20 20 0  20 20 20 0  20 20 20 21 0  0  0  0  0  0  0  20
20 20 20 20 0  20 20 20 0  20 20 20 21 0  0  0  0  0  0  0  20
20 20 20 20 0  20 20 20 0  20 20 20 21 0  0  0  0  0  0  0  20
20 20 20 20 0  20 20 20 0  20 20 20 21 0  0  0  0  0  0  0  20
20 20 20 20 0  20 20 20 0  20 20 20 21 0  0  0  21 0  0  0  20
20 20 20 20 0  20 20 20 0  20 20 20 21 0  0  0  0  0  0  0  20
20 20 20 20 0  20 20 20 0  20 20 20 21 0  0  0  0  0  0  0  20
20 20 20 20 0  20 20 20 0  20 20 20 21 0  0  0  0  0  0  0  20
20 20 20 20 0  20 20 20 0  20 20 20 21 0  0  0  0  0  0  0  20
20 20 20 20 0  20 20 20 0  20 20 20 21 0  0  0  0  0  0  0  20
20 20 20 20 0  20 20 20 0  20 20 20 21 0  0  0  21 0  0  0  20
20 20 20 20 0  20 20 20 0  20 20 20 21 0  0  0  0  0  0  0  20
20 20 20 20 0  20 20 20 0  20 20 20 21 0  0  0  0  0  0  0  20
20 20 20 20 0  20 20 20 0  20 20 20 21 0  0  0  0  0  0  0  20
20 20 20 20 0  20 20 20 0  20 20 20 21 0  0  0  0  0  0  0  20
20 20 20 20 0  20 20 20 0  20 20 20 21 0  0  0  0  0  0  0  20
20 20 20 20 0  20 20 20 0  20 20 20 21 0  0  0  21 0  0  0  20
20 20 20 20 0  0  0  0  0  20 20 20 21 0  0  0  0  0  0  0  20
20 20 20 20 20 20 0  20 20 20 20 20 21 0  0  0  0  0  0  0  20
20 0  0  0  0  0  0  0  0  0  0  0  21 0  0  0  0  0  0  0  20
20 0  0  0  0  0  0  0  0  0  0  0  21 0  0  0  0  0  0  0  20
20 0  0  0  0  0  0  0  0  0  0  0  21 0  0  0  0  0  0  0  20
20 0  0  0  0  0  0  0  0  0  0  0  21 0  0  0  21 0  0  0  20
20 0  0  0  0  0  0  0  0  0  0  0  21 0  0  0  0  0  0  0  20
20 0  0  0  0  0  0  0  0  0  0  0  21 0  0  0  0  0  0  0  20
20 0  0  0  0  0  0  0  0  0  0  0  21 0  0  0  0  0  0  0  20
20 0  0  0  0  0  0  0  0  0  0  0  21 0  0  0  0  0  0  0  20
20 0  0  0  0  0  0  0  0  0  0  0  21 0  0  0  0  0  0  0  20
20 0  0  0  0  0  0  0  0  0  0  0  21 0  0  0  21 0  0  0  20
20 0  0  0  0  0  0  0  0  0  0  0  21 0  0  0  0  0  0  0  20
20 0  0  0  0  0  0  0  0  0  0  0  21 0  0  0  0  0  0  0  20
20 0  0  0  0  0  0  0  0  0  0  0  21 0  0  0  0  0  0  0  20
20 0  0  0  0  0  0  0  0  0  0  0  21 0  0  0  0  0  0  0  20
20 0  0  0  0  0  0  0  0  0  0  0  21 0  0  0  0  0  0  0  20
20 0  0  0  0  0  0  0  0  0  0  0  21 0  0  0  21 0  0  0  20
20 0  0  0  0  0  0  0  0  0  0  0  21 0  0  0  0  0  0  0  20
20 0  0  0  0  0  0  0  0  0  0  0  21 0  0  0  0  0  0  0  20
20 0  0  0  0  0  0  0  0  0  0  0  21 0  0  0  0  0  0  0  20
20 0  0  0  0  0  0  0  0  0  0  0  21 0  0  0  0  0  0  0  20
20 0  0  0  0  0  0  0  0  0  0  0  21 0  0  0  0  0  0  0  20
20 0  0  0  0  0  0  0  0  0  0  0  21 0  0  0  21 0  0  0  20
20 0  0  0  0  0  0  0  0  0  0  0  21 0  0  0  0  0  0  0  20
20 0  0  0  0  0  0  0  0  0  0  0  21 0  0  0  0  0  0  0  20
20 21 21 21 21 21 21 21 21 21 21 21 21 0  0  0  0  0  0  0  20
20 1  21 21 21 21 21 21 21 21 21 21 21 0  0  0  0  0  0  0  20
1  0  0  0  0  0  0  0  0  0  0  0  0  0  0  0  0  0  0  0  20
1  1  20 20 20 20 20 20 20 20 20 20 20 20 20 20 20 20 20 20 20
