47 47 47 47 47 47 47 47 47 47 47 47 47 47 47 47 47 47 47 47 47 47 47 47 47 47 47 47 47 47 47 47 47 47 47 47 47 47 47 47 47 47 47
47 0  0  0  0  0  0  0  0  0  0  0  0  0  0  0  0  0  47 0  0  0  0  0  0  0  0  0  0  0  0  0  0  0  0  0  0  0  0  0  0  0  47
47 0  47 47 47 47 47 47 47 47 47 47 47 47 47 47 47 0  47 47 0  47 47 47 47 47 47 47 47 47 47 47 47 47 47 47 47 47 47 47 47 0  47
47 0  47 0  0  0  0  0  0  0  0  0  0  0  0  0  0  0  0  0  0  47 0  0  0  0  0  0  0  0  0  0  0  0  0  0  0  47 0  0  47 0  47
47 0  47 0  47 47 47 47 47 47 47 47 47 47 47 47 47 47 47 47 47 47 47 47 47 47 47 47 47 0  47 47 47 0  47 47 47 47 47 0  47 0  47
47 0  47 0  47 0  0  0  0  0  0  0  0  0  0  0  0  0  0  0  0  0  0  0  0  0  0  0  0  0  0  47 0  0  0  0  0  0  47 0  47 47 47
47 0  47 0  47 0  47 47 47 47 47 47 47 47 47 47 47 47 47 47 47 47 47 47 47 47 47 47 0  47 47 47 47 47 47 47 47 0  47 0  47 0  47
47 0  47 0  47 0  47 0  0  0  0  0  0  0  0  0  0  0  0  0  0  0  0  0  0  0  0  0  0  0  0  0  0  0  0  0  47 0  47 0  47 0  47
47 0  47 0  47 0  47 0  47 47 47 47 47 47 47 47 47 47 47 47 47 47 47 47 47 47 47 47 47 47 47 47 47 47 47 0  47 0  47 0  47 0  47
47 0  47 0  47 0  47 0  47 0  0  0  0  0  0  0  0  0  0  0  0  0  0  0  0  0  0  0  0  0  0  0  0  0  47 0  47 0  47 0  47 0  47
47 0  47 0  47 0  47 47 47 0  47 47 47 47 47 47 47 47 47 47 47 47 47 47 47 47 47 47 47 47 47 47 47 0  47 0  47 0  47 0  0  0  47
47 0  47 0  47 0  47 0  47 0  0  0  0  0  0  0  0  0  0  0  0  0  0  0  0  0  0  0  0  0  0  0  47 0  47 0  47 0  47 0  47 0  47
47 0  47 0  47 0  47 0  47 0  47 47 47 47 47 47 47 47 47 47 47 47 47 47 47 47 47 47 47 47 47 0  47 0  47 0  47 0  47 0  47 0  47
47 0  47 0  47 0  47 0  47 0  47 0  0  0  0  0  0  0  0  0  0  0  0  0  0  0  0  0  0  0  47 0  47 0  47 0  47 0  47 47 47 0  47
47 0  47 0  47 0  47 0  47 0  47 0  0  0  47 47 47 47 47 47 47 47 47 47 47 47 47 47 47 0  47 0  47 0  47 0  47 0  47 0  47 0  47
47 0  47 0  47 0  47 0  47 0  47 0  0  0  0  0  0  0  0  0  0  47 0  0  0  0  0  0  0  0  47 0  47 0  47 0  47 0  47 0  47 0  47
47 47 47 0  47 0  47 0  47 0  47 0  0  0  0  0  47 47 47 47 47 1  47 47 47 47 47 47 47 0  47 0  47 0  47 0  47 0  47 0  47 0  47
47 0  47 0  47 0  47 0  47 0  47 0  0  0  47 0  0  0  0  0  0  0  1  47 0  0  0  0  0  0  47 0  47 0  0  0  47 0  0  0  47 0  47
47 0  47 0  47 0  47 0  47 0  47 0  0  0  47 0  47 47 47 47 47 1  47 47 47 47 47 47 47 0  47 0  47 0  47 0  47 47 47 0  47 0  47
47 0  47 0  47 0  47 0  47 0  47 0  47 47 47 0  0  0  0  0  0  47 0  0  0  0  0  0  0  0  47 0  47 0  47 0  47 0  47 0  47 0  47
47 0  0  0  47 0  47 0  47 0  47 0  0  0  47 47 47 47 47 47 47 47 47 47 47 47 47 0  47 47 47 0  47 0  47 0  47 0  47 0  47 0  47
47 0  47 0  47 0  47 0  47 0  47 0  0  0  0  0  0  0  0  0  0  0  0  0  0  0  0  0  0  0  0  0  47 0  47 0  47 0  47 0  47 0  47
47 0  47 0  47 0  47 0  47 0  47 47 47 47 47 47 47 47 47 47 47 47 47 47 47 47 47 47 47 47 47 47 47 0  47 0  47 0  47 0  47 0  47
47 0  47 0  47 0  47 0  47 0  0  0  0  0  0  0  0  0  0  0  0  0  0  0  0  0  0  0  0  0  0  0  0  0  47 0  47 0  47 0  47 0  47
47 0  47 0  47 0  47 0  47 47 47 47 47 47 47 47 47 47 47 47 47 47 47 47 47 47 47 47 47 47 47 47 47 47 47 0  47 0  47 0  47 0  47
47 0  47 0  47 47 47 0  0  0  0  0  0  0  0  0  0  0  0  0  0  0  0  0  0  0  0  0  0  0  0  0  0  0  0  0  47 0  47 0  47 0  47
47 0  47 0  47 0  47 47 47 47 47 47 47 47 47 47 47 47 47 47 47 47 47 47 47 47 47 47 47 47 47 47 47 47 47 47 0  0  47 0  0  0  47
47 0  47 0  47 0  0  0  0  0  0  0  47 0  0  0  0  0  0  0  0  0  0  0  0  0  0  0  0  0  0  0  0  0  0  0  0  0  47 0  47 0  47
47 0  47 0  47 0  47 47 47 47 47 47 47 47 47 47 47 47 47 47 47 47 47 0  47 47 47 47 47 0  47 47 47 47 47 0  47 47 47 0  47 0  47
47 0  47 0  0  0  47 0  0  0  0  0  0  0  0  0  0  0  0  0  0  0  0  0  0  47 0  0  47 0  0  0  0  47 0  0  0  0  0  0  47 47 47
47 0  47 47 47 47 47 0  47 47 47 47 47 47 47 47 47 47 47 47 47 47 47 47 47 47 0  47 47 47 47 47 47 47 47 47 47 47 47 47 47 0  47
47 0  0  0  0  0  0  0  0  0  0  0  0  0  0  0  0  0  0  0  0  0  0  0  0  0  0  0  0  0  0  0  0  0  0  0  0  0  0  0  0  0  47
47 47 47 47 47 47 47 47 47 47 47 47 47 47 47 47 47 47 47 47 47 47 47 47 47 47 47 47 47 47 47 47 47 47 47 47 47 47 47 47 47 47 47
