36 36 36 36 36 36 36 36 36 36 36 36 36 36 36 36 36 36 36 36 36 36 36 36 36 36 36
36 0  0  0  0  0  0  18 18 18 18 18 0  0  0  0  0  18 18 18 18 18 0  0  0  0  57
36 0  0  0  0  0  0  18 0  0  0  18 0  0  0  0  0  18 0  0  0  18 0  0  0  0  57
36 0  18 18 18 18 0  18 0  0  0  18 0  18 18 18 18 18 0  0  0  18 0  0  0  0  57
36 0  18 0  0  18 0  18 18 0  18 18 0  18 0  0  18 18 18 0  18 18 18 18 18 0  57
36 0  18 0  0  0  0  0  0  0  0  0  0  18 0  0  0  0  0  0  0  0  0  0  0  0  57
36 0  18 0  0  18 18 18 18 18 18 0  0  18 0  0  18 0  0  0  18 18 18 18 0  0  57
36 0  18 18 18 18 18 0  0  0  18 0  0  18 18 18 18 0  0  0  18 0  0  18 0  0  57
36 0  0  0  0  0  18 0  0  0  18 0  0  0  0  0  0  0  0  0  18 0  0  0  0  0  57
36 0  0  0  0  0  18 18 0  18 18 0  0  0  0  0  0  0  0  0  18 0  0  18  0  0  57
36 0  18 18 18 18 0  0  0  0  0  0  0  0  0  0  18 18 18 18 18 18 18 18 0  0  57
36 0  18 0  0  18 0  0  0  0  18 18 0  18 18 0  18 0  0  18 0  0  0  18 0  0  57
36 0  0  0  0  18 0  0  0  0  18 0  0  0  18 0  0  0  0  18 0  0  0  18 0  0  57
36 0  18 0  0  18 0  0  0  0  18 0  0  0  18 0  18 0  0  18 18 0  18 18 0  0  57
36 0  18 18 18 18 0  0  0  0  18 18 18 18 18 0  18 18 18 18 18 0  0  0  0  0  57
36 0  0  0  0  0  0  0  0  0  18 0  0  0  18 0  0  18 0  0  18 18 18 18 18 0  57
36 0  0  18 18 18 18 0  0  0  18 0  0  0  18 0  0  0  0  0  18 18 0  0  18 0  57
36 0  0  18 0  0  18 0  0  0  18 18 0  18 18 0  0  18 0  0  18 18 0  0  0  0  57
36 0  0  18 0  0  0  0  0  0  18 0  0  0  0  0  0  18 18 18 18 18 0  0  18 0  57
36 0  0  18 0  0  18 0  18 18 18 18 18 18 18 18 0  18 18 18 18 18 18 18 18 0  57
36 0  18 18 0  18 18 0  0  0  0  18 0  0  0  18 0  18 0  0  18 0  0  0  0  0  57
36 0  18 0  0  0  18 0  18 0  0  18 0  0  0  18 0  18 0  0  0  0  0  0  0  0  57
36 0  18 0  0  0  18 0  18 0  0  18 18 0  18 18 0  18 0  0  18 0  18 18 18 18 57
36 0  18 18 18 18 18 0  18 18 18 18 18 0  0  0  0  18 18 18 18 0  18 0  0  18 57
36 0  0  0  0  0  0  0  18 18 1  18 18 0  0  0  0  0  0  0  0  0  0  0  0  18 57
36 18 0  18 18 18 18 0  18 1  0  1  18 18 18 0  18 18 0  0  0  0  18 0  0  18 57
36 0  0  18 0  0  18 0  18 18 0  18 18 18 0  0  0  18 0  0  0  0  18 18 18 18 57
36 0  0  0  0  0  18 0  0  0  0  0  0  18 0  0  0  18 0  0  0  0  0  0  0  0  57
36 0  0  18 0  0  18 18 18 18 18 18 0  18 0  0  0  18 0  18 18 18 18 18 0  0  57
36 0  0  18 18 18 18 18 0  0  0  18 0  18 18 18 18 18 0  18 0  0  0  18 0  0  57
36 0  0  0  0  0  0  18 0  0  0  18 0  0  0  0  0  0  0  18 0  0  0  18 0  0  57
36 0  0  0  0  0  0  18 18 0  18 18 0  0  0  0  0  0  0  18 18 0  18 18 0  0  57
36 0  0  0  0  0  0  0  0  0  0  0  0  0  0  0  0  0  0  18 0  0  0  0  0  0  57
36 57 57 57 57 57 57 57 57 57 57 57 57 57 57 57 57 57 57 57 57 57 57 57 57 57 57
