22 22 22 22 22 22 22 22 22 22 22
22 0  0  0  0  0  0  0  0  0  22
22 0  0  0  0  0  0  0  0  0  22
22 22 22 22 0  0  0  0  0  0  22
22 0  0  0  0  0  0  0  0  0  22
22 0  0  0  22 22 22 0  0  0  22
22 0  0  0  0  0  0  0  0  0  22
22 0  0  0  0  0  0  22 22 22 22
22 22 22 22 0  0  0  0  0  0  22
22 0  0  22 22 22 0  22 22 22 22
22 0  0  0  0  0  0  0  0  0  22
22 0  0  0  0  0  0  0  0  0  22
22 0  0  0  0  0  0  0  0  0  22
22 22 24 22 0  22 0  22 28 22 22
22 0  0  0  0  22 0  0  0  0  22
22 0  22 22 22 22 22 22 22 0  22
22 0  22 0  0  0  0  0  22 0  22
22 0  22 0  22 22 22 0  22 0  22
22 0  22 0  22 1  22 0  22 0  22
22 0  22 0  22 0  22 0  22 0  22
22 0  22 0  22 0  22 0  22 0  22
22 0  22 0  22 0  22 0  22 0  22
22 0  22 0  22 0  22 0  22 0  22
22 0  22 0  22 0  22 0  22 0  22
22 0  22 0  22 0  22 0  22 0  22
22 0  22 0  22 0  22 0  22 0  22
22 0  22 0  0  0  22 0  22 0  22
22 0  22 22 22 22 22 0  22 0  22
22 0  0  0  0  0  0  0  22 0  22
22 22 22 22 22 22 22 22 22 0  22
22 0  0  0  0  0  0  0  0  0  22
22 0  22 22 22 22 22 22 22 22 22
22 0  0  0  0  0  0  0  0  0  22
22 22 22 22 22 0  22 22 22 22 22
22 0  0  0  0  0  0  0  0  0  22
22 0  0  0  0  0  0  0  0  0  22
22 0  0  0  22 22 22 0  0  0  22
22 0  0  0  0  22 0  0  0  0  22
22 0  0  0  0  22 0  0  0  0  22
22 0  0  0  0  22 0  0  0  0  22
22 0  0  0  0  22 0  0  0  0  22
22 0  0  0  0  22 0  0  0  0  22
22 0  0  0  0  22 0  0  0  0  22
22 22 22 0  22 22 22 0  22 22 22
22 0  22 0  0  22 0  0  22 0  22
22 0  22 22 0  22 0  22 22 0  22
22 0  0  22 0  22 0  22 0  0  22
22 0  0  22 0  22 0  22 0  0  22
22 0  0  22 0  22 0  22 0  0  22
22 0  0  22 0  22 0  22 0  0  22
22 0  0  22 0  22 0  22 0  0  22
22 0  0  22 0  22 0  22 0  0  22
22 0  0  22 0  22 0  22 0  0  22
22 0  0  22 0  22 0  22 0  0  22
22 0  0  22 0  22 0  22 0  0  22
22 0  22 22 0  22 0  22 22 22 22
22 0  22 0  0  22 0  0  0  0  22
22 0  22 0  22 22 22 22 22 0  22
22 0  22 0  22 0  0  0  22 0  22
22 0  22 0  22 0  22 22 22 0  22
22 0  22 0  22 0  0  0  22 0  22
22 0  22 0  22 22 22 0  22 0  22
22 0  22 0  0  0  22 0  22 0  22
22 0  22 0  22 0  22 0  22 0  22
22 0  22 0  22 0  22 0  22 0  22
22 0  22 0  0  0  22 0  22 0  22
22 0  22 0  22 22 22 0  22 0  22
22 0  22 0  22 0  0  0  22 0  22
22 0  22 0  22 0  22 22 22 0  22
22 0  22 0  22 0  0  0  22 0  22
22 0  22 0  22 22 22 0  22 0  22
22 0  22 0  22 0  22 0  0  0  22
22 0  22 0  22 0  22 22 22 22 22
22 0  22 0  22 0  0  0  0  0  22
22 0  22 0  22 0  0  0  0  0  22
22 0  22 0  22 0  0  0  0  0  22
22 0  0  0  0  0  0  0  0  0  22
22 0  0  0  0  0  0  0  0  0  22
22 0  0  0  0  0  0  0  0  0  22
22 22 22 0  22 22 22 0  22 22 22
22 22 22 0  22 0  22 0  22 0  22
22 22 22 0  22 0  22 0  22 0  22
22 22 22 0  22 0  22 0  22 0  22
22 22 0  0  22 0  0  0  22 0  22
22 22 0  22 22 22 22 0  22 0  22
22 22 0  0  0  0  22 0  22 0  22
22 22 22 22 22 0  22 0  22 0  22
22 0  0  0  22 0  22 0  22 0  22
22 0  0  0  22 0  22 0  0  0  22
22 22 22 22 22 0  22 22 22 0  22
22 22 0  0  0  0  22 0  22 0  22
22 22 0  22 22 22 22 0  22 0  22
22 22 0  22 22 22 22 0  0  0  22
22 22 0  0  0  0  22 0  22 22 22
22 22 22 22 22 0  22 0  0  0  22
22 0  0  0  22 0  22 22 22 0  22
22 0  0  0  22 0  22 0  0  0  22
22 0  0  0  22 0  22 0  22 22 22
22 0  0  0  22 0  22 0  0  0  22
22 0  0  0  22 0  22 22 22 0  22
22 0  0  22 22 0  22 22 0  0  22
22 0  0  22 1  0  1  22 0  22 22
22 0  0  22 22 1  22 22 0  0  22
22 22 22 22 22 22 22 22 22 22 22
